xxxxxxxxxxxxxxxx
xv   sx   sx v x
x     xs   x   x
x  x  x  x x x x
x  x  x  x x xsx
x sx  x vx x x x
x  x  x  x xsx x
x  x  x  x x xsx
x  xv x  xsx x x
x  x  s  x   x x
xp x     x v xfx
xxxxxxxxxxxxxxxx
